11111111111111111111111111111111111111
10001000000000000000000000000000000001
10C010000000000000000000000000000P0001
10001000000000000000000000000000000001
10001000000000000000000000000000000001
10001000000000000000001110000000000001
10001111111100000000000000000000000001
100000000000000000000000C0000000000001
10000000000000000000000000000000000001
11111111111111111111111100000000011111
10000000000000000000000000000000000001
100E0000000000000000000000000000000001
10000000000000000001111111111100000001
10000000000000000000000C00000000000001
10000000000000000000000000000000000001
11111111111111111111111111111111111111