1111111111111
10010000000C1
10000111110E1
1P00110000001
1111111111111