11111111
1000P001
1000E001
1000CP01
11111111
