11111111111011
10PEC000000001
10000000000000
11111111111111