1111111
1000P01
1E00001
1111111
