11111111
10001001
1111001
10000PE1
1000C111
11111111
